0 0 1 2 M M 2 1 1 0 1 M 1 1 M 1
0 0 1 M 4 3 2 M 2 1 1 1 1 1 1 1
0 0 1 2 M 2 3 4 M 1 0 0 0 0 0 0
0 1 1 2 2 3 M M 3 2 1 0 0 1 1 1
1 2 M 1 2 M 4 2 2 M 1 0 0 1 M 1
1 M 3 2 3 M 2 0 1 1 1 0 0 1 1 1
1 1 2 M 2 1 1 0 0 0 0 0 0 0 0 0
0 0 1 2 2 1 0 1 2 2 1 0 0 0 0 0
0 1 1 3 M 3 1 2 M M 2 1 0 0 0 0
0 1 M 5 M 5 M 2 3 4 M 1 0 0 0 0
0 1 2 M M M 2 1 1 M 2 1 0 0 1 1
0 0 1 3 4 3 1 0 1 1 2 2 3 2 2 M
1 1 0 1 M 1 0 0 0 0 2 M M M 2 1
M 2 0 1 1 1 0 0 0 0 3 M 6 3 2 0
M 2 0 0 0 0 0 0 1 1 3 M 4 M 1 0
1 1 0 0 0 0 0 0 1 M 2 2 M 2 1 0