0 0 0 1 M 1 0 1 M 4 M M M 1 0 0
0 1 1 2 1 1 1 2 3 M M 5 3 2 1 1
0 1 M 1 0 0 1 M 2 2 2 3 M 2 1 M
1 2 2 1 0 0 2 2 2 1 2 5 M 3 1 1
1 M 1 0 0 0 1 M 2 2 M M M 4 1 1
1 2 2 1 0 0 1 2 M 2 2 4 M 3 M 1
0 1 M 1 1 1 1 1 1 2 1 3 2 3 1 1
0 1 1 1 1 M 1 0 0 1 M 2 M 1 0 0
0 1 1 1 1 1 1 0 0 1 1 2 1 1 0 0
0 1 M 1 0 0 0 1 1 1 0 1 1 2 1 1
0 1 1 1 0 0 1 2 M 2 1 2 M 3 M 2
0 0 0 0 1 1 3 M 3 2 M 2 2 M 3 M
1 1 0 0 1 M 3 M 2 2 2 2 1 1 3 2
M 1 1 1 2 1 2 1 1 1 M 1 0 0 1 M
1 1 1 M 1 0 1 1 1 1 2 2 1 0 1 1
0 0 1 1 1 0 1 M 1 0 1 M 1 0 0 0